{
  "name": "dirt",
  "enabled": true,
  "tileMap":[
    [0,0,0,0,0,0,0,12,12,12,12,12,12,12,12,12,12,12,12,12],
    [0,0,0,0,0,0,0,12,12,12,12,12,12,0,0,0,0,0,12,12],
    [0,0,12,12,12,0,0,12,12,12,12,12,12,0,0,0,0,0,12,12],
    [0,0,12,12,12,0,0,12,12,0,0,0,0,0,0,12,0,0,12,12],
    [0,0,12,12,12,0,0,12,12,0,0,0,0,0,0,12,0,0,12,12],
    [0,0,0,0,12,0,0,0,12,0,0,12,12,12,12,12,0,0,12,12],
    [0,0,0,0,12,0,0,0,12,0,0,12,12,12,12,12,0,0,12,12],
    [12,12,0,0,12,12,0,0,12,0,0,12,12,12,12,12,0,0,12,12],
    [0,0,0,0,12,12,0,0,0,0,0,12,12,12,12,12,0,0,12,12],
    [0,0,0,0,12,12,0,0,0,0,0,12,12,12,12,12,9,9,12,12]
  ],
  "playerSpawnPositions": [
    { "name": "player_1", "positions":[5, 570] },
    { "name": "player_2", "positions":[5, 635] }
  ],
  "power_ups":[
    {"type": "oil", "chance": 1, "positions": [850, 300]},
    {"type": "speed", "chance": 1, "positions": [380, 420]}
  ]
}