{
  "name": "Dirt",
  "enabled": true,
  "tileMap":[
    [0,12,12,12,12,0,0,0,0,0,0,12,12,12,12,12,12,12,12,12],
    [12,12,12,0,0,0,0,0,0,0,0,12,12,0,0,0,0,0,12,12],
    [0,0,0,0,0,0,0,12,12,0,0,12,12,0,0,0,0,0,12,12],
    [0,0,0,0,12,12,12,12,12,0,0,0,0,0,0,12,0,0,12,12],
    [0,0,12,12,12,12,12,12,12,0,0,0,0,0,0,12,0,0,12,12],
    [0,0,0,0,12,12,12,12,12,12,12,12,12,12,12,12,0,0,12,12],
    [0,0,0,0,12,12,12,12,12,12,12,12,12,12,12,12,0,0,12,12],
    [12,12,0,0,12,12,12,12,12,12,12,12,12,12,12,12,0,0,12,12],
    [0,0,0,0,12,12,12,12,12,12,12,12,12,12,12,12,0,0,12,12],
    [0,0,0,0,12,12,12,12,12,12,12,12,12,12,12,12,9,9,12,12]
  ],
  "playerSpawnPositions": [
    { "name": "player_1", "positions":[5, 570] },
    { "name": "player_2", "positions":[5, 635] }
  ],
  "power_ups":[
    {"type": "oil", "chance": 1, "positions": [630, 200]},
    {"type": "speed", "chance": 0.50, "positions": [120, 150]}
  ]
}