{
  "name": "Grass (Da ba dee)",
  "enabled": true,
  "tileMap":[
    [0,0,13,13,13,13,13,13,13,0,0,0,0,0,0,13,13,13,13,13],
    [0,0,0,0,0,0,0,13,13,0,0,0,0,0,0,13,13,13,13,13],
    [0,0,0,0,0,0,0,13,13,0,0,13,13,0,0,13,13,13,13,13],
    [0,0,13,13,13,0,0,0,0,0,0,13,0,0,0,13,13,13,13,13],
    [0,0,13,13,13,0,0,0,0,0,0,13,0,0,0,13,13,13,13,13],
    [0,0,0,0,13,13,0,0,13,0,0,13,0,0,0,0,0,0,13,13],
    [0,0,0,0,13,13,0,0,13,0,0,13,0,0,0,0,0,0,13,13],
    [13,13,0,0,13,13,0,0,13,0,0,13,13,13,13,13,0,0,13,13],
    [0,0,0,0,13,13,0,0,0,0,0,0,0,0,0,0,0,0,0,9],
    [0,0,0,0,13,13,0,0,0,0,0,0,0,0,0,0,0,0,0,9]
  ],
  "playerSpawnPositions": [
    { "name": "player_1", "positions":[5, 570] },
    { "name": "player_2", "positions":[5, 635] }
  ],
  "power_ups":[
    {"type": "oil", "chance": 1, "positions": [850, 300]},
    {"type": "speed", "chance": 1, "positions": [380, 250]}
  ]
}