{
  "name": "Water",
  "enabled": true,
  "tileMap":[
    [7,3,3,3,3,3,3,3,3,3,3,3,3,3,3,3,3,3,3,8],
    [6,4,4,4,4,4,4,4,4,4,4,4,4,4,4,4,4,4,0,2],
    [10,10,10,10,10,10,10,10,10,10,10,10,10,10,10,10,10,10,1,2],
    [9,9,10,10,10,10,10,10,10,10,10,10,10,10,10,10,10,10,1,2],
    [1,2,10,10,10,10,10,10,10,10,10,10,10,10,10,10,10,10,1,2],
    [1,2,10,10,10,10,10,10,10,10,10,10,10,10,10,10,10,10,1,2],
    [1,2,10,10,10,10,10,10,10,10,10,10,10,10,10,10,10,10,1,2],
    [1,2,10,10,10,10,10,10,10,10,10,10,10,10,10,10,10,10,1,2],
    [1,0,3,3,3,3,3,3,3,3,3,3,3,3,3,3,3,3,0,2],
    [6,4,4,4,4,4,4,4,4,4,4,4,4,4,4,4,4,4,4,5]
  ],
  "playerSpawnPositions": [
    { "name": "player_1", "positions":[25, 10] },
    { "name": "player_2", "positions":[25, 70] }
  ],
  "power_ups":[
    {"type": "oil", "chance": 0.10, "positions": [1350, 400]},
    {"type": "speed", "chance": 1, "positions": [850, 650]}
  ]
}