{
  "name": "Water",
  "tileMap":[
    [7,3,3,3,3,3,3,3,3,3,3,3,3,3,3,3,3,3,3,8],
    [1,0,4,4,4,4,4,4,4,4,4,4,4,4,4,4,4,4,0,2],
    [1,2,9,9,9,9,9,9,9,9,9,9,9,9,9,9,9,9,1,2],
    [1,2,9,9,9,9,9,9,9,9,9,9,9,9,9,9,9,9,1,2],
    [1,2,9,9,9,9,9,9,9,9,9,9,9,9,9,9,9,9,1,2],
    [1,2,9,9,9,9,9,9,9,9,9,9,9,9,9,9,9,9,1,2],
    [1,2,9,9,9,9,9,9,9,9,9,9,9,9,9,9,9,9,1,2],
    [1,2,9,9,9,9,9,9,9,9,9,9,9,9,9,9,9,9,1,2],
    [1,0,3,3,3,3,3,3,3,3,3,3,3,3,3,3,3,3,0,2],
    [6,4,4,4,4,4,4,4,4,4,4,4,4,4,4,4,4,4,4,5]
  ],
  "playerSpawnPositions": [
    { "name": "player_1", "positions":[50, 50] },
    { "name": "player_2", "positions":[100, 100] }
  ]
}